{
  "ㄱ": 8,
  "ㄴ": 9,
  "ㄷ": 10,
  "ㄹ": 11,
  "ㅁ": 12,
  "ㅂ": 13,
  "ㅅ": 14,
  "ㅇ": 15,
  "ㅈ": 16,
  "ㅊ": 17,
  "ㅋ": 18,
  "ㅌ": 19,
  "ㅍ": 20,
  "ㅎ": 21,
  "ㅏ": 22,
  "ㅐ": 23,
  "ㅑ": 24,
  "ㅓ": 25,
  "ㅔ": 26,
  "ㅕ": 27,
  "ㅗ": 28,
  "ㅛ": 29,
  "ㅜ": 30,
  "ㅠ": 31,
  "ㅡ": 32,
  "ㅣ": 33,
  "<⇧>": 6,
  "<␣>": 7
}