{
  "ㄱ": 19,
  "ㄴ": 20,
  "ㄷ": 21,
  "ㄹ": 22,
  "ㅁ": 23,
  "ㅂ": 24,
  "ㅅ": 25,
  "ㅇ": 26,
  "ㅈ": 27,
  "ㅊ": 28,
  "ㅋ": 29,
  "ㅌ": 30,
  "ㅍ": 31,
  "ㅎ": 32,
  "ㅏ": 33,
  "ㅐ": 34,
  "ㅑ": 35,
  "ㅓ": 36,
  "ㅔ": 37,
  "ㅕ": 38,
  "ㅗ": 39,
  "ㅛ": 40,
  "ㅜ": 41,
  "ㅠ": 42,
  "ㅡ": 43,
  "ㅣ": 44,
  "[SHIFT]": 17,
  "[BLANK]": 18
}